{
    "tileset" : "tileset/mine.png",
    "terrain" : [
		[1, 1, 1, 1, 1, 1, 1, 1, 1,  1,  1,  1,  1,  1,  1],
                [1, 1, 1, 1, 1, 1, 1, 1, 1,  1,  1,  1,  1,  1,  1],
                [1, 1, 1, 1, 1, 1, 1, 1, 1,  1,  1,  1,  1,  1,  1],
                [1, 1, 1, 1, 1, 1, 1, 1, 1,  1,  1,  1,  1,  1,  1],
                [1, 1, 1, 1, 1, 1, 1, 1, 1,  1,  1,  1,  1,  1,  1],
                [1, 1, 1, 1, 1, 1, 1, 1, 1,  1,  1,  1,  1,  1,  1],
                [1, 1, 1, 1, 1, 1, 1, 1, 1,  1,  1,  1,  1,  1,  1],
                [1, 1, 1, 1, 1, 1, 1, 1, 1,  1,  1,  1,  1,  1,  1],
                [1, 1, 1, 1, 1, 1, 1, 1, 1,  1,  1,  1,  1,  1,  1],
                [1, 1, 1, 1, 1, 1, 1, 1, 1,  1,  1,  1,  1,  1,  1],
                [1, 1, 1, 1, 1, 1, 1, 1, 1,  1,  1,  1,  1,  1,  1],
                [1, 1, 1, 1, 1, 1, 1, 1, 1,  1,  1,  1,  1,  1,  1],
                [1, 1, 1, 1, 1, 1, 1, 1, 1,  1,  1,  1,  1,  1,  1],
                [1, 1, 1, 1, 1, 1, 1, 1, 1,  1,  1,  1,  1,  1,  1],
                [1, 1, 1, 1, 1, 1, 1, 1, 1,  1,  1,  1,  1,  1,  1]
	],
    "decors" : [
                [130, 130, 27, 29, 0, 0, 0, 0, 0, 0,  0,  0,  0,  0,  0],
		[130, 130, 36, 36, 0, 0, 0, 0, 0, 0,  0,  0,  0,  0,  0],
                [130, 130, 36, 38, 0, 0, 0, 0, 0, 0,  0,  0,  0,  0,  0],
                [130, 130, 36, 31, 28, 28, 0, 27, 28, 0,  0,  0,  0,  0,  0],
                [130, 130, 45, 46, 46, 46, 0, 45, 46, 0,  0,  0,  0,  0,  0],
                [130, 130, 54, 55, 55, 55, 0, 54, 55, 0,  0,  0,  0,  0,  0],
                [130, 130, 63, 64, 64, 64, 0, 63, 64, 0,  0,  0,  0,  0,  0],
                [190, 199, 190, 0, 0, 0, 0, 0, 0, 0,  0,  0,  0,  0,  0],
                [190, 190, 190, 0, 0, 0, 0, 0, 0, 0,  0,  0,  0,  0,  0],
                [130, 130, 0, 0, 0, 0, 0, 0, 0, 0,  0,  0,  0,  0,  0],
                [130, 130, 0, 0, 0, 0, 0, 0, 0, 0,  0,  0,  0,  0,  0],
                [130, 130, 0, 0, 0, 0, 0, 0, 0, 0,  0,  0,  0,  0,  0],
                [130, 130, 0, 0, 0, 0, 0, 0, 0, 0,  0,  0,  0,  0,  0],
                [130, 130, 0, 0, 0, 0, 0, 0, 0, 0,  0,  0,  0,  0,  0],
                [130, 130, 130, 130, 130, 0, 0, 0, 0, 0,  0,  0,  0,  0,  0]
		
	]    
}
