{
    "tileset" : "tileset/mine.png",
        "terrain0" : [
		[1, 1, 1, 1, 1, 1, 1, 1, 1,  1,  1,  1,  1,  1,  1],
                [1, 1, 1, 1, 1, 1, 1, 1, 1,  1,  1,  1,  1,  1,  1],
                [1, 1, 1, 1, 1, 1, 1, 1, 1,  1,  1,  1,  1,  1,  1],
                [1, 1, 1, 1, 1, 1, 1, 1, 1,  1,  1,  1,  1,  1,  1],
                [1, 1, 1, 1, 1, 1, 1, 1, 1,  1,  1,  1,  1,  1,  1],
                [1, 1, 1, 1, 1, 1, 1, 1, 1,  1,  1,  1,  1,  1,  1],
                [1, 1, 1, 1, 1, 1, 1, 1, 1,  1,  1,  1,  1,  1,  1],
                [1, 1, 1, 1, 1, 1, 1, 1, 1,  1,  1,  1,  1,  1,  1],
                [1, 1, 1, 1, 1, 1, 1, 1, 1,  1,  1,  1,  1,  1,  1],
                [1, 1, 1, 1, 1, 1, 1, 1, 1,  1,  1,  1,  1,  1,  1],
                [1, 1, 1, 1, 1, 1, 1, 1, 1,  1,  1,  1,  1,  1,  1],
                [1, 1, 1, 1, 1, 1, 1, 1, 1,  1,  1,  1,  1,  1,  1],
                [1, 1, 1, 1, 1, 1, 1, 1, 1,  1,  1,  1,  1,  1,  1],
                [1, 1, 1, 1, 1, 1, 1, 1, 1,  1,  1,  1,  1,  1,  1],
                [1, 1, 1, 1, 1, 1, 1, 1, 1,  1,  1,  1,  1,  1,  1]
	],
   
        
        "terrain1" : [
		[0, 0, 0, 0, 0, 0, 0, 0, 0, 0, 0, 0, 0, 0, 0],
		[0, 0, 0, 0, 68, 0, 0, 0, 0, 0, 0, 0, 0, 0, 0],
                [0, 0, 0, 0, 76, 0, 0, 0, 0, 0, 348, 0, 0, 0, 0],
                [0, 0, 0, 0, 0, 0, 0, 0, 0, 0, 356, 0, 0, 0, 0],
                [0, 0, 0, 0, 0, 0, 0, 0, 0, 0, 0, 0, 0, 0, 0],
                [0, 0, 0, 0, 0, 0, 0, 0, 0, 0, 0, 0, 0, 0, 0],
                [0, 0, 0, 0, 0, 0, 0, 0, 0, 0, 0, 0, 0, 0, 0],
                [0, 0, 0, 0, 0, 0, 0, 0, 0, 0, 0, 0, 0, 0, 0],
                [0, 0, 0, 0, 0, 0, 0, 0, 0, 0, 0, 0, 0, 0, 0],
                [0, 0, 0, 0, 0, 0, 0, 0, 0, 0, 0, 0, 0, 0, 0],
                [0, 0, 0, 0, 0, 0, 0, 0, 0, 0, 0, 0, 0, 0, 0],
                [0, 0, 0, 0, 0, 0, 0, 169, 0, 0, 0, 0, 0, 0, 0],
                [0, 0, 0, 0, 0, 0, 0, 177, 0, 0, 0, 0, 0, 0, 0],
                [0, 0, 0, 0, 0, 0, 0, 185, 0, 0, 0, 0, 0, 0, 0],
                [0, 0, 0, 0, 0, 0, 0, 0, 0, 0, 0, 0, 0, 0, 0]
		
	],
             
    "terrain2" : [
                [29, 34, 34, 34, 34, 34, 34, 34, 34, 34, 34, 34, 34, 34, 28],
		[27, 42, 42, 42, -1, 42, 42, 42, 42, 42, 42, 42, 42, 42, 25],
                [27, 50, 50, 50, 0, 50, 50, 50, 50, 50, 50, 50, 50, 50, 25, 25],
                [27, 0, 0, 0, 0, 0, 0, 0, 0, 0, 0, 0, 0, 0, 25],
                [27, 0, 0, 0, 0, 0, 0, 0, 0, 0, 0, 0, 0, 0, 25],
                [27, 0, 0, 0, 0, 0, 0, 0, 0, 0, 0, 0, 0, 0, 25],
                [27, 0, 0, 0, 0, 0, 0, 0, 0, 0, 0, 0, 0, 0, 25],
                [27, 0, 0, 0, 0, 0, 0, 0, 0, 0, 0, 0, 0, 0, 25],
                [27, 0, 0, 0, 0, 0, 0, 0, 0, 0, 0, 0, 0, 0, 25],
                [21, 0, 0, 0, 0, 0, 0, 0, 0, 0, 0, 0, 0, 0, 20],
                [34, 34, 34, 34, 34, 34, 35, 0, 33, 34, 34, 34, 34, 34, 34],
                [42, 42, 42, 42, 42, 42, 43, 0, 41, 42, 42, 42, 42, 42, 42],
                [106, 106, 106, 106, 106, 106, 107, 0, 105, 106, 106, 106, 106, 106, 106],
                [109, 109, 109, 109, 109, 109, 109, 0, 109, 109, 109, 109, 109, 109, 109],
                [0, 0, 0, 0, 0, 0, 0, 0, 0, 0, 0, 0, 0, 0, 0]
		
	],
        
    "terrain3" : [
                [0, 0, 0, 0, 0, 0, 0, 0, 0,  0,  0,  0,  0,  0,  0],
                [0, 0, 0, 0, 0, 0, 0, 0, 0,  0,  0,  0,  0,  0,  0],
                [0, 0, 0, 0, 0, 0, 0, 0, 0,  0,  0,  0,  0,  0,  0],
                [0, 0, 0, 0, 0, 0, 0, 0, 0,  0,  0,  0,  0,  0,  0],
                [0, 0, 0, 0, 0, 0, 0, 0, 0,  0,  0,  0,  0,  0,  0],
                [0, 0, 0, 0, 0, 0, 361,362, 363,  0,  0,  0,  0,  0,  0],
                [0, 0, 0, 0, 0, 0, 369, 370, 371,  0,  0,  0,  0,  0,  0],
                [0, 0, 0, 0, 0, 0, 377, 378, 379, 0,  0,  0,  0,  0,  0],
                [0, 0, 0, 0, 0, 0, 385, 386, 387,  0,  0,  0,  0,  0,  0],
                [0, 18, 18, 18, 18, 18, 19, 0, 17,  18,  18,  18,  18,  18,  0],
                [0, 0, 0, 0, 0, 0, 0, 0, 0,  0,  0,  0,  0,  0,  0],
                [0, 0, 0, 0, 0, 0, 0, 0, 0,  0,  0,  0,  0,  0,  0],
                [0, 0, 0, 0, 0, 0, 0, 0, 0,  0,  0,  0,  0,  0,  0],
                [0, 0, 0, 0, 0, 0, 0, 0, 0,  0,  0,  0,  0,  0,  0],
                [0, 0, 0, 0, 0, 0, 0, 0, 0,  0,  0,  0,  0,  0,  0]
	],
    "posjoueur": [
        [7],[14],[0] 
    ],
    "pnjs": [
        ["goblin.png", 10,   6,    1],
        ["goblin.png", 10,   7,   1]
    ]
}
