{
    "tileset" : "tileset/mine.png",
    "terrain" : [
		[1, 1, 1, 1, 1, 1, 1, 1, 1,  1,  1,  1,  1,  1,  1],
                [1, 1, 1, 1, 1, 1, 1, 1, 1,  1,  1,  1,  1,  1,  1],
                [1, 1, 1, 1, 1, 1, 1, 1, 1,  1,  1,  1,  1,  1,  1],
                [1, 1, 1, 1, 1, 1, 1, 1, 1,  1,  1,  1,  1,  1,  1],
                [1, 1, 1, 1, 1, 1, 1, 1, 1,  1,  1,  1,  1,  1,  1],
                [1, 1, 1, 1, 1, 1, 1, 1, 1,  1,  1,  1,  1,  1,  1],
                [1, 1, 1, 1, 1, 1, 1, 1, 1,  1,  1,  1,  1,  1,  1],
                [1, 1, 1, 1, 1, 1, 1, 1, 1,  1,  1,  1,  1,  1,  1],
                [1, 1, 1, 1, 1, 1, 1, 1, 1,  1,  1,  1,  1,  1,  1],
                [1, 1, 1, 1, 1, 1, 1, 1, 1,  1,  1,  1,  1,  1,  1],
                [1, 1, 1, 1, 1, 1, 1, 1, 1,  1,  1,  1,  1,  1,  1],
                [1, 1, 1, 1, 1, 1, 1, 1, 1,  1,  1,  1,  1,  1,  1],
                [1, 1, 1, 1, 1, 1, 1, 1, 1,  1,  1,  1,  1,  1,  1],
                [1, 1, 1, 1, 1, 1, 1, 1, 1,  1,  1,  1,  1,  1,  1],
                [1, 1, 1, 1, 1, 1, 1, 1, 1,  1,  1,  1,  1,  1,  1],
	],
    "decors" : [
                [130, 130, 27, 29, 144, 144, 144, 144, 144, 144,  144,  144,  144,  144,  144],
		[130, 130, 36, 36, 0, 144, 144, 144, 144, 144,  144,  144,  144,  144,  144],
                [130, 130, 36, 38, 144, 144, 144, 144, 144, 144,  144,  144,  144,  144,  144],
                [130, 130, 36, 31, 28, 28, 144, 27, 28, 144,  144,  144,  144,  144,  144],
                [130, 130, 45, 46, 46, 46, 144, 45, 46, 144,  144,  144,  144,  144,  144],
                [130, 130, 54, 55, 55, 55, 144, 54, 55, 144,  144,  144,  144,  144,  144],
                [130, 130, 63, 64, 64, 64, 144, 63, 64, 144,  144,  144,  144,  144,  144],
                [190, 199, 190, 144, 144, 144, 144, 144, 144, 144,  144,  144,  144,  144,  144],
                [190, 190, 190, 144, 144, 144, 144, 144, 144, 144,  144,  144,  144,  144,  144],
                [130, 130, 144, 144, 144, 144, 144, 144, 144, 144,  144,  144,  144,  144,  144],
                [130, 130, 144, 144, 144, 144, 144, 144, 144, 144,  144,  144,  144,  144,  144],
                [130, 130, 144, 144, 144, 144, 144, 144, 144, 144,  144,  144,  144,  144,  144],
                [130, 130, 144, 144, 144, 144, 144, 144, 144, 144,  144,  144,  144,  144,  144],
                [130, 130, 144, 144, 144, 144, 144, 144, 144, 144,  144,  144,  144,  144,  144],
                [130, 130, 130, 130, 130, 144, 144, 144, 144, 144,  144,  144,  144,  144,  144]
		
	]    
}
